1111111111111111111111
1000000000M00000000001
10P0000000000000000C01
1000000000000000000001
1000000000111111111111
1000CC0000000100CCC001
1000CC0000000100000001
1000CC00001111000000M1
1000000000000000000001
1000000000000M11111111
1000000000000000000001
1000000000000000000E01
1111111111111111111111