1111111111111111111111
1000000000000000000001
10P0000000000000000C01
1000000000000000000001
1000000000111111111111
1000CC0000000100CCC001
1000CC0000000100000001
1000CC0000111100000001
1000000000000000000001
1000000000000011111111
1000000000000000000001
1000000000000000000E01
1111111111111111111111